........................................................................................................................................
........................................................................................................................................
........................................................................................................................................
........................................................................................................................................
........................................................................................................................................
........................................................................................................................................
........................................................................................................................................
........................................................................................................................................
........................................................................................................................................
........................................................................................................................................
........................................................................................................................................
........................................................................................................................................
..................................................................................#####################.................................
..................................................................................#####################.................................
..................................................................................########################################..............
..................................................................................########################################..............
..................................................................................#####################.................##..............
.....................................#######################......................#####################.................##..............
.....................................#######################......................#####################.........$$......##..............
..................................................................................#####################.........##......##..............
..................................................................................#####################.................##..............
...................................................########################.......#####################..#########......##..............
...................................................########################.......#####################.................####............
..................................................................................#####################............#########............
.............................................................................##########################.................................
.....................................................................###########################################........................
......................................................#################################################.................................
########################################################################################################################################